GHC.PArr	base
Unsafe.Coerce	base
Data.Tuple	base
Data.String	base
Data.Ord	base
Data.Maybe	base
Data.Eq	base
Data.Either	base
Text.Show	base
Data.Bool	base
Data.Bits	base
Control.Monad	base
Text.ParserCombinators.ReadP	base
Text.ParserCombinators.ReadPrec	base
Text.Read.Lex	base
Data.Word	base
Data.Int	base
Data.Char	base
Data.List	base
Numeric	base
Foreign.C.Types	base
Foreign.Storable	base
Data.Typeable	base
Data.HashTable	base
Data.Dynamic	base
Foreign.StablePtr	base
System.IO.Error	base
System.IO.Unsafe	base
Foreign.Ptr	base
Foreign.Marshal.Error	base
Foreign.Concurrent	base
Foreign.ForeignPtr	base
Foreign.Marshal.Alloc	base
Foreign.Marshal.Utils	base
Foreign.Marshal.Array	base
Foreign.C.String	base
Foreign.C.Error	base
Foreign.C	base
Foreign.Marshal.Pool	base
Foreign.Marshal	base
Foreign	base
System.Posix.Types	base
GHC.Conc	base
System.IO	base
GHC.Dotnet	base
Text.Read	base
Prelude	base
Control.Monad.Instances	base
Data.Fixed	base
Data.Function	base
Control.Monad.Fix	base
Control.Monad.ST	base
Control.Monad.ST.Strict	base
Control.Monad.ST.Lazy	base
Data.Generics.Basics	base
Data.Complex	base
Data.Generics.Aliases	base
Data.Generics.Instances	base
Data.Generics.Schemes	base
Data.Generics.Text	base
Data.Generics.Twins	base
Data.Generics	base
Data.IORef	base
Data.Ix	base
Data.Monoid	base
Data.Ratio	base
Data.STRef	base
Data.STRef.Lazy	base
Data.STRef.Strict	base
Data.Version	base
Debug.Trace	base
GHC.Environment	base
GHC.Exts	base
System.CPUTime	base
System.Console.GetOpt	base
System.Exit	base
System.Info	base
System.Mem	base
System.Mem.StableName	base
System.Mem.Weak	base
Text.Printf	base
Text.Show.Functions	base
Control.Exception	base
System.Environment	base
Control.Concurrent.MVar	base
Control.Concurrent.QSem	base
Control.Concurrent.QSemN	base
Control.Concurrent.SampleVar	base
Data.Unique	base
Control.Concurrent.Chan	base
Control.Concurrent	base
GHC.ConsoleHandler	base
System.Timeout	base
Control.Arrow	base
Control.Applicative	base
Data.Foldable	base
Data.Traversable	base
Language.Haskell.Extension	Cabal
Distribution.Verbosity	Cabal
Distribution.System	Cabal
Distribution.Simple.PreProcess.Unlit	Cabal
Distribution.Simple.GHC.Makefile	Cabal
Distribution.License	Cabal
Distribution.Extension	Cabal
Distribution.Compiler	Cabal
Distribution.Compat.ReadP	Cabal
Distribution.Version	Cabal
Distribution.Configuration	Cabal
Distribution.Package	Cabal
Distribution.InstalledPackageInfo	Cabal
Distribution.Simple.Compiler	Cabal
Distribution.Simple.Utils	Cabal
Distribution.PackageDescription	Cabal
Distribution.Simple.Program	Cabal
Distribution.Simple.Setup	Cabal
Distribution.Make	Cabal
Distribution.Setup	Cabal
Distribution.Simple.InstallDirs	Cabal
Distribution.Simple.LocalBuildInfo	Cabal
Distribution.Simple.GHC.PackageConfig	Cabal
Distribution.Simple.GHC	Cabal
Distribution.Simple.JHC	Cabal
Distribution.Simple.NHC	Cabal
Distribution.Simple.PreProcess	Cabal
Distribution.Simple.Hugs	Cabal
Distribution.Simple.Install	Cabal
Distribution.Simple.Register	Cabal
Distribution.Simple.Configure	Cabal
Distribution.Simple.Build	Cabal
Distribution.Simple.Haddock	Cabal
Distribution.Simple.SrcDist	Cabal
Distribution.Simple	Cabal
Distribution.Simple.SetupWrapper	Cabal
Test.HUnit.Terminal	HUnit
Test.HUnit.Lang	HUnit
Test.HUnit.Base	HUnit
Test.HUnit.Text	HUnit
Test.HUnit	HUnit
Test.QuickCheck	QuickCheck
Test.QuickCheck.Batch	QuickCheck
Test.QuickCheck.Utils	QuickCheck
Test.QuickCheck.Poly	QuickCheck
Debug.QuickCheck.Utils	QuickCheck
Debug.QuickCheck.Poly	QuickCheck
Debug.QuickCheck.Batch	QuickCheck
Debug.QuickCheck	QuickCheck
Data.Array	array
Data.Array.IArray	array
Data.Array.MArray	array
Data.Array.ST	array
Data.Array.Storable	array
Data.Array.Unboxed	array
Data.Array.IO	array
Data.Array.Diff	array
Control.Arrow.Transformer	arrows
Control.Arrow.Operations	arrows
Control.Arrow.Transformer.CoState	arrows
Control.Arrow.Transformer.Automaton	arrows
Control.Arrow.Transformer.Error	arrows
Control.Arrow.Transformer.Reader	arrows
Control.Arrow.Transformer.State	arrows
Control.Arrow.Transformer.Static	arrows
Control.Arrow.Transformer.Stream	arrows
Control.Arrow.Transformer.Writer	arrows
Data.ByteString.Internal	bytestring
Data.ByteString.Lazy.Internal	bytestring
Data.ByteString.Unsafe	bytestring
Data.ByteString	bytestring
Data.ByteString.Char8	bytestring
Data.ByteString.Lazy	bytestring
Data.ByteString.Lazy.Char8	bytestring
Network.CGI.Protocol	cgi
Network.CGI.Monad	cgi
Network.CGI.Cookie	cgi
Network.CGI	cgi
Data.Set	containers
Data.Sequence	containers
Data.Tree	containers
Data.Map	containers
Data.IntSet	containers
Data.IntMap	containers
Data.Graph	containers
System.Directory	directory
System.FilePath.Windows	filepath
System.FilePath.Posix	filepath
System.FilePath	filepath
Language.Haskell.Syntax	haskell
Language.Haskell.Pretty	haskell
Language.Haskell.Parser	haskell
Control.Monad.Writer.Class	mtl
Control.Monad.Trans	mtl
Control.Monad.State.Class	mtl
Control.Monad.Reader.Class	mtl
Control.Monad.RWS.Class	mtl
Control.Monad.Identity	mtl
Control.Monad.Error.Class	mtl
Control.Monad.Cont.Class	mtl
Control.Monad.Error	mtl
Control.Monad.List	mtl
Control.Monad.RWS.Lazy	mtl
Control.Monad.RWS	mtl
Control.Monad.RWS.Strict	mtl
Control.Monad.Reader	mtl
Control.Monad.State.Lazy	mtl
Control.Monad.State	mtl
Control.Monad.State.Strict	mtl
Control.Monad.Writer.Lazy	mtl
Control.Monad.Writer	mtl
Control.Monad.Writer.Strict	mtl
Control.Monad.Cont	mtl
System.Locale	old
System.Time	old
Data.PackedString	packedstring
Control.Parallel	parallel
Control.Parallel.Strategies	parallel
Text.ParserCombinators.Parsec.Pos	parsec
Text.ParserCombinators.Parsec.Error	parsec
Text.ParserCombinators.Parsec.Prim	parsec
Text.ParserCombinators.Parsec.Combinator	parsec
Text.ParserCombinators.Parsec.Expr	parsec
Text.ParserCombinators.Parsec.Char	parsec
Text.ParserCombinators.Parsec	parsec
Text.ParserCombinators.Parsec.Perm	parsec
Text.ParserCombinators.Parsec.Token	parsec
Text.ParserCombinators.Parsec.Language	parsec
Text.PrettyPrint.HughesPJ	pretty
Text.PrettyPrint	pretty
System.Process	process
System.Cmd	process
System.Random	random
Control.Monad.STM	stm
Control.Concurrent.STM.TVar	stm
Control.Concurrent.STM.TMVar	stm
Control.Concurrent.STM.TChan	stm
Control.Concurrent.STM.TArray	stm
Control.Concurrent.STM	stm
Language.Haskell.TH.Syntax	template
Language.Haskell.TH.PprLib	template
Language.Haskell.TH.Ppr	template
Language.Haskell.TH.Lib	template
Language.Haskell.TH	template
Data.Time.Calendar.MonthDay	time
Data.Time.Calendar.Julian	time
Data.Time.Calendar.OrdinalDate	time
Data.Time.Calendar.WeekDate	time
Data.Time.Clock.POSIX	time
Data.Time.Clock	time
Data.Time.Calendar	time
Data.Time.Calendar.Easter	time
Data.Time.LocalTime	time
Data.Time.Clock.TAI	time
Data.Time.Format	time
Data.Time	time
Text.XHtml.Frameset	xhtml
Text.XHtml.Strict	xhtml
Text.XHtml.Transitional	xhtml
Text.XHtml.Table	xhtml
Text.XHtml.Debug	xhtml
Text.XHtml	xhtml
System.Glib.Types	gtk
System.Glib.GList	gtk
System.Glib.Flags	gtk
System.Glib.FFI	gtk
System.Glib.GType	gtk
System.Glib.GTypeConstants	gtk
System.Glib.GValue	gtk
System.Glib.GParameter	gtk
System.Glib.GObject	gtk
System.Glib.MainLoop	gtk
System.Glib.UTFString	gtk
System.Glib.GError	gtk
System.Glib.GValueTypes	gtk
System.Glib.Signals	gtk
System.Gnome.GConf.GConfValue	gtk
System.Gnome.GConf.GConfClient	gtk
System.Gnome.GConf	gtk
System.Glib.Attributes	gtk
System.Glib.Properties	gtk
System.Glib.StoreValue	gtk
System.Glib	gtk
Graphics.UI.Gtk.Windows.WindowGroup	gtk
Graphics.UI.Gtk.TreeList.CellRenderer	gtk
Graphics.UI.Gtk.SourceView.SourceMarker	gtk
Graphics.UI.Gtk.SourceView.SourceLanguagesManager	gtk
Graphics.UI.Gtk.Pango.Enums	gtk
Graphics.UI.Gtk.Multiline.TextTagTable	gtk
Graphics.UI.Gtk.Multiline.TextMark	gtk
Graphics.UI.Gtk.Misc.SizeGroup	gtk
Graphics.UI.Gtk.Gdk.Keys	gtk
Graphics.UI.Gtk.Gdk.Gdk	gtk
Graphics.UI.Gtk.Gdk.Enums	gtk
Graphics.UI.Gtk.General.Enums	gtk
Graphics.UI.Gtk.Multiline.TextTag	gtk
Graphics.UI.Gtk.Embedding.Embedding	gtk
Graphics.UI.Gtk.ActionMenuToolbar.ToggleAction	gtk
Graphics.UI.Gtk.ActionMenuToolbar.RadioAction	gtk
Graphics.UI.Gtk.Abstract.Separator	gtk
Graphics.UI.Gtk.Abstract.Scrollbar	gtk
Graphics.UI.Gtk.Abstract.Object	gtk
Graphics.UI.Gtk.Abstract.Range	gtk
Graphics.UI.Gtk.Abstract.Scale	gtk
Graphics.UI.Gtk.ActionMenuToolbar.UIManager	gtk
Graphics.UI.Gtk.Buttons.Button	gtk
Graphics.UI.Gtk.Buttons.CheckButton	gtk
Graphics.UI.Gtk.Buttons.RadioButton	gtk
Graphics.UI.Gtk.Buttons.ToggleButton	gtk
Graphics.UI.Gtk.Display.AccelLabel	gtk
Graphics.UI.Gtk.Display.ProgressBar	gtk
Graphics.UI.Gtk.Display.Statusbar	gtk
Graphics.UI.Gtk.Embedding.Plug	gtk
Graphics.UI.Gtk.Embedding.Socket	gtk
Graphics.UI.Gtk.Entry.Editable	gtk
Graphics.UI.Gtk.Entry.Entry	gtk
Graphics.UI.Gtk.Entry.HScale	gtk
Graphics.UI.Gtk.Entry.VScale	gtk
Graphics.UI.Gtk.General.General	gtk
Graphics.UI.Gtk.General.Structs	gtk
Graphics.UI.Gtk.ActionMenuToolbar.Action	gtk
Graphics.UI.Gtk.ActionMenuToolbar.ActionGroup	gtk
Graphics.UI.Gtk.Display.Image	gtk
Graphics.UI.Gtk.Entry.SpinButton	gtk
Graphics.UI.Gtk.Gdk.Pixbuf	gtk
Graphics.UI.Gtk.Gdk.Region	gtk
Graphics.UI.Gtk.Gdk.Events	gtk
Graphics.UI.Gtk.Gdk.DrawWindow	gtk
Graphics.UI.Gtk.General.StockItems	gtk
Graphics.UI.Gtk.Gdk.GC	gtk
Graphics.UI.Gtk.General.IconFactory	gtk
Graphics.UI.Gtk.General.Style	gtk
Graphics.UI.Gtk.Multiline.TextIter	gtk
Graphics.UI.Gtk.Multiline.TextBuffer	gtk
Graphics.UI.Gtk.Abstract.Widget	gtk
Graphics.UI.Gtk.Gdk.Drawable	gtk
Graphics.UI.Gtk.Gdk.Pixmap	gtk
Graphics.UI.Gtk.Pango.Font	gtk
Graphics.UI.Gtk.Pango.Context	gtk
Graphics.UI.Gtk.Pango.Markup	gtk
Graphics.UI.Gtk.Display.Label	gtk
Graphics.UI.Gtk.Pango.Rendering	gtk
Graphics.UI.Gtk.Pango.Layout	gtk
Graphics.UI.Gtk.SourceView.SourceTagStyle	gtk
Graphics.UI.Gtk.SourceView.SourceStyleScheme	gtk
Graphics.UI.Gtk.SourceView.SourceTag	gtk
Graphics.UI.Gtk.SourceView.SourceTagTable	gtk
Graphics.UI.Gtk.TreeList.TreeIter	gtk
Graphics.UI.Gtk.Entry.EntryCompletion	gtk
Graphics.UI.Gtk.TreeList.TreeModel	gtk
Graphics.UI.Gtk.TreeList.ListStore	gtk
Graphics.UI.Gtk.TreeList.TreeStore	gtk
Graphics.UI.Gtk.TreeList.TreeModelSort	gtk
Graphics.UI.Gtk.Glade	gtk
Graphics.UI.Gtk.Layout.Alignment	gtk
Graphics.UI.Gtk.Layout.AspectFrame	gtk
Graphics.UI.Gtk.Layout.Expander	gtk
Graphics.UI.Gtk.Layout.HBox	gtk
Graphics.UI.Gtk.Layout.HButtonBox	gtk
Graphics.UI.Gtk.Layout.HPaned	gtk
Graphics.UI.Gtk.Layout.VBox	gtk
Graphics.UI.Gtk.Layout.VButtonBox	gtk
Graphics.UI.Gtk.Layout.VPaned	gtk
Graphics.UI.Gtk.MenuComboToolbar.CheckMenuItem	gtk
Graphics.UI.Gtk.MenuComboToolbar.ComboBox	gtk
Graphics.UI.Gtk.MenuComboToolbar.ComboBoxEntry	gtk
Graphics.UI.Gtk.MenuComboToolbar.ImageMenuItem	gtk
Graphics.UI.Gtk.MenuComboToolbar.MenuBar	gtk
Graphics.UI.Gtk.MenuComboToolbar.MenuItem	gtk
Graphics.UI.Gtk.MenuComboToolbar.MenuShell	gtk
Graphics.UI.Gtk.MenuComboToolbar.MenuToolButton	gtk
Graphics.UI.Gtk.MenuComboToolbar.OptionMenu	gtk
Graphics.UI.Gtk.MenuComboToolbar.RadioMenuItem	gtk
Graphics.UI.Gtk.MenuComboToolbar.RadioToolButton	gtk
Graphics.UI.Gtk.MenuComboToolbar.SeparatorMenuItem	gtk
Graphics.UI.Gtk.MenuComboToolbar.SeparatorToolItem	gtk
Graphics.UI.Gtk.MenuComboToolbar.TearoffMenuItem	gtk
Graphics.UI.Gtk.MenuComboToolbar.ToggleToolButton	gtk
Graphics.UI.Gtk.MenuComboToolbar.ToolButton	gtk
Graphics.UI.Gtk.MenuComboToolbar.ToolItem	gtk
Graphics.UI.Gtk.Misc.Adjustment	gtk
Graphics.UI.Gtk.Misc.Arrow	gtk
Graphics.UI.Gtk.Misc.Calendar	gtk
Graphics.UI.Gtk.Misc.DrawingArea	gtk
Graphics.UI.Gtk.Misc.EventBox	gtk
Graphics.UI.Gtk.Misc.HandleBox	gtk
Graphics.UI.Gtk.Misc.Tooltips	gtk
Graphics.UI.Gtk.Misc.Viewport	gtk
Graphics.UI.Gtk.Mogul.WidgetTable	gtk
Graphics.UI.Gtk.Mogul.GetWidget	gtk
Graphics.UI.Gtk.MozEmbed	gtk
Graphics.UI.Gtk.Multiline.TextView	gtk
Graphics.UI.Gtk.Ornaments.Frame	gtk
Graphics.UI.Gtk.Ornaments.HSeparator	gtk
Graphics.UI.Gtk.Ornaments.VSeparator	gtk
Graphics.UI.Gtk.Scrolling.HScrollbar	gtk
Graphics.UI.Gtk.Scrolling.ScrolledWindow	gtk
Graphics.UI.Gtk.Scrolling.VScrollbar	gtk
Graphics.UI.Gtk.Selectors.ColorButton	gtk
Graphics.UI.Gtk.Selectors.ColorSelection	gtk
Graphics.UI.Gtk.Selectors.ColorSelectionDialog	gtk
Graphics.UI.Gtk.Selectors.FileChooser	gtk
Graphics.UI.Gtk.Selectors.FileChooserButton	gtk
Graphics.UI.Gtk.Selectors.FileChooserWidget	gtk
Graphics.UI.Gtk.Selectors.FileFilter	gtk
Graphics.UI.Gtk.Selectors.FileSelection	gtk
Graphics.UI.Gtk.Selectors.FontButton	gtk
Graphics.UI.Gtk.Selectors.FontSelection	gtk
Graphics.UI.Gtk.Selectors.FontSelectionDialog	gtk
Graphics.UI.Gtk.SourceView.SourceBuffer	gtk
Graphics.UI.Gtk.SourceView.SourceIter	gtk
Graphics.UI.Gtk.SourceView.SourceLanguage	gtk
Graphics.UI.Gtk.SourceView.SourceView	gtk
Graphics.UI.Gtk.SourceView	gtk
Graphics.UI.Gtk.TreeList.CellRendererPixbuf	gtk
Graphics.UI.Gtk.TreeList.CellRendererText	gtk
Graphics.UI.Gtk.TreeList.CellRendererToggle	gtk
Graphics.UI.Gtk.TreeList.CellView	gtk
Graphics.UI.Gtk.TreeList.IconView	gtk
Graphics.UI.Gtk.TreeList.TreeSelection	gtk
Graphics.UI.Gtk.TreeList.TreeViewColumn	gtk
Graphics.UI.Gtk.TreeList.TreeView	gtk
Graphics.UI.Gtk.Windows.AboutDialog	gtk
Graphics.UI.Gtk.Windows.Dialog	gtk
Graphics.UI.Gtk.Windows.Window	gtk
Graphics.UI.Gtk.Selectors.FileChooserDialog	gtk
Graphics.UI.Gtk.Abstract.Misc	gtk
Graphics.UI.Gtk.Abstract.Paned	gtk
Graphics.UI.Gtk.Layout.Fixed	gtk
Graphics.UI.Gtk.Layout.Layout	gtk
Graphics.UI.Gtk.Layout.Notebook	gtk
Graphics.UI.Gtk.Layout.Table	gtk
Graphics.UI.Gtk.MenuComboToolbar.Menu	gtk
Graphics.UI.Gtk.MenuComboToolbar.Toolbar	gtk
Graphics.UI.Gtk.Abstract.Container	gtk
Graphics.UI.Gtk.MenuComboToolbar.Combo	gtk
Graphics.UI.Gtk.Abstract.ButtonBox	gtk
Graphics.UI.Gtk.Abstract.Box	gtk
Graphics.UI.Gtk.Abstract.Bin	gtk
Graphics.Rendering.Cairo.Matrix	gtk
Graphics.Rendering.Cairo	gtk
Graphics.UI.Gtk.Cairo	gtk
Graphics.UI.Gtk	gtk
Graphics.UI.Gtk.Mogul.NewWidget	gtk
Graphics.UI.Gtk.Mogul.MDialog	gtk
Graphics.UI.Gtk.Mogul.TreeList	gtk
Graphics.UI.Gtk.Mogul	gtk
